+------------OUR MAP!----------------+
|! *      *            ********** *  |
|  *  * * *  **********         * *  |
|  *  *      *********   *****  * *  |
|       * *                  *    *  |
|********** ******assdg ***  * *  *  |
|     *         ************ * *     |
| ************  **             *  *  |
|               ** ****asg******  *  |
|***********  **** *              *  |
|          *       *  * ***********  |
|  ******  *  ******  *   *          |
|       *             ************** |
|*** **************   *       *    * |
|                 * * *  *    * **   |
| ***************** * *  * ****   ***|
|      *            * *    * *       |
|**** *********** *** ** *** * ***** |
|               *              *     |
+------------------------------------+